0 0 0 0 0 0 0 0 0 0 0 0 0 0 0
0 71 35 36 23 37 63 1 27 73 44 39 64 58 0
0 59 67 38 77 24 70 66 63 65 26 64 62 46 0
0 57 28 54 72 77 53 74 86 53 43 71 61 68 0
0 89 26 23 81 68 97 8 37 94 75 60 11 44 0
0 98 13 52 11 62 91 30 57 45 54 64 28 48 0
0 20 94 48 18 47 30 87 66 38 33 66 23 60 0
0 59 55 29 63 8 13 20 10 57 29 15 42 60 0
0 83 78 35 46 89 57 71 33 2 66 82 79 91 0
0 14 13 9 38 42 25 74 43 17 29 1 25 63 0
0 90 64 55 27 78 7 68 24 57 59 99 58 37 0
0 63 25 38 24 1 24 26 69 47 99 85 1 32 0
0 21 66 25 44 10 91 56 3 56 52 27 78 20 0
0 78 72 64 90 31 12 99 82 96 90 23 63 20 0
0 49 5 47 43 3 73 93 9 13 31 13 15 54 0
0 45 49 66 77 30 92 92 10 32 2 4 73 50 0
0 6 32 22 47 73 31 31 96 67 4 90 8 82 0
0 81 39 72 64 9 92 48 97 75 53 39 37 50 0
0 26 92 79 34 59 60 26 88 23 96 5 41 23 0
0 80 31 48 40 52 59 88 67 88 80 64 69 95 0
0 58 66 35 46 14 91 41 28 63 80 97 31 5 0
0 29 80 11 73 83 48 47 41 58 79 5 76 44 0
0 69 80 81 15 22 25 38 57 87 75 17 83 9 0
0 0 0 0 0 0 0 0 0 0 0 0 0 0 0